	На сколько 178 меньше 96841?	-1
	На сколько 308 меньше 85103?	-1
	На сколько 37 меньше 65506?	-1
	На сколько 740 меньше 32543?	-1
	На сколько 874 меньше 19053?	-1
	На сколько 915 меньше 25556?	-1
	На сколько 62 меньше 69022?	-1
	На сколько 941 меньше 52867?	-1
	На сколько 98 меньше 34774?	-1
	На сколько 629 меньше 22855?	-1
	На сколько 317 меньше 16718?	-1
	На сколько 439 меньше 15561?	-1
	На сколько 713 меньше 24415?	-1
	На сколько 737 меньше 10348?	-1
	На сколько 476 меньше 58531?	-1
	На сколько 502 меньше 14293?	-1
На полке лежит 11 книг.	Сколько всего страниц в этих книгах?	-1
На полке лежит 93 книг.	Сколько всего страниц в этих книгах?	-1
На полке лежит 22 книг.	Сколько всего страниц в этих книгах?	-1
На полке лежит 57 книг.	Сколько всего страниц в этих книгах?	-1
На полке лежит 40 книг.	Сколько всего страниц в этих книгах?	-1
На полке лежит 44 книг.	Сколько всего страниц в этих книгах?	-1
На полке лежит 24 книг.	Сколько всего страниц в этих книгах?	-1
На полке лежит 61 книг.	Сколько всего страниц в этих книгах?	-1
На полке лежит 6 книг.	Сколько всего страниц в этих книгах?	-1
На полке лежит 46 книг.	Сколько всего страниц в этих книгах?	-1
На полке лежит 65 книг.	Сколько всего страниц в этих книгах?	-1
На полке лежит 80 книг.	Сколько всего страниц в этих книгах?	-1
На полке лежит 83 книг.	Сколько всего страниц в этих книгах?	-1
На полке лежит 58 книг.	Сколько всего страниц в этих книгах?	-1
На полке лежит 52 книг.	Сколько всего страниц в этих книгах?	-1
На полке лежит 33 книг.	Сколько всего страниц в этих книгах?	-1
У Альбины на 28 друзей больше, чем у Антона.	Сколько друзей у Альбины?	-1
У Альбины на 25 друзей больше, чем у Антона.	Сколько друзей у Альбины?	-1
У Альбины на 7 друзей больше, чем у Антона.	Сколько друзей у Альбины?	-1
У Альбины на 8 друзей больше, чем у Антона.	Сколько друзей у Альбины?	-1
У Альбины на 21 друзей больше, чем у Антона.	Сколько друзей у Альбины?	-1
У Альбины на 28 друзей больше, чем у Антона.	Сколько друзей у Альбины?	-1
У Альбины на 4 друзей больше, чем у Антона.	Сколько друзей у Альбины?	-1
У Альбины на 23 друзей больше, чем у Антона.	Сколько друзей у Альбины?	-1
У Альбины на 15 друзей больше, чем у Антона.	Сколько друзей у Альбины?	-1
У Альбины на 24 друзей больше, чем у Антона.	Сколько друзей у Альбины?	-1
У Альбины на 3 друзей больше, чем у Антона.	Сколько друзей у Альбины?	-1
У Альбины на 27 друзей больше, чем у Антона.	Сколько друзей у Альбины?	-1
У Альбины на 25 друзей больше, чем у Антона.	Сколько друзей у Альбины?	-1
У Альбины на 15 друзей больше, чем у Антона.	Сколько друзей у Альбины?	-1
У Альбины на 23 друзей больше, чем у Антона.	Сколько друзей у Альбины?	-1
У Альбины на 18 друзей больше, чем у Антона.	Сколько друзей у Альбины?	-1
У Альбины на 4 друзей больше, чем у Антона.	Сколько друзей у Альбины?	-1
У Альбины на 8 друзей больше, чем у Антона.	Сколько друзей у Альбины?	-1
У Альбины на 11 друзей больше, чем у Антона.	Сколько друзей у Альбины?	-1
У Альбины на 17 друзей больше, чем у Антона.	Сколько друзей у Альбины?	-1
У Альбины на 14 друзей больше, чем у Антона.	Сколько друзей у Альбины?	-1
У Альбины на 15 друзей больше, чем у Антона.	Сколько друзей у Альбины?	-1
У Альбины на 18 друзей больше, чем у Антона.	Сколько друзей у Альбины?	-1
У Альбины на 21 друзей больше, чем у Антона.	Сколько друзей у Альбины?	-1
У Альбины на 9 друзей больше, чем у Антона.	Сколько друзей у Альбины?	-1
Петька съел 36 ягод смордины. А Мишка съел на 30 ягод больше.	Сколько лет Петьке и Мишке в сумме?	-1
Петька съел 6 ягод смордины. А Мишка съел на 12 ягод больше.	Сколько лет Петьке и Мишке в сумме?	-1
Петька съел 33 ягод смордины. А Мишка съел на 7 ягод больше.	Сколько лет Петьке и Мишке в сумме?	-1
Петька съел 17 ягод смордины. А Мишка съел на 10 ягод больше.	Сколько лет Петьке и Мишке в сумме?	-1
Петька съел 30 ягод смордины. А Мишка съел на 25 ягод больше.	Сколько лет Петьке и Мишке в сумме?	-1
Петька съел 18 ягод смордины. А Мишка съел на 17 ягод больше.	Сколько лет Петьке и Мишке в сумме?	-1
Петька съел 38 ягод смордины. А Мишка съел на 13 ягод больше.	Сколько лет Петьке и Мишке в сумме?	-1
Петька съел 2 ягод смордины. А Мишка съел на 34 ягод больше.	Сколько лет Петьке и Мишке в сумме?	-1
Петька съел 35 ягод смордины. А Мишка съел на 36 ягод больше.	Сколько лет Петьке и Мишке в сумме?	-1
Петька съел 39 ягод смордины. А Мишка съел на 6 ягод больше.	Сколько лет Петьке и Мишке в сумме?	-1
Петька съел 28 ягод смордины. А Мишка съел на 34 ягод больше.	Сколько лет Петьке и Мишке в сумме?	-1
Петька съел 23 ягод смордины. А Мишка съел на 34 ягод больше.	Сколько лет Петьке и Мишке в сумме?	-1
Петька съел 5 ягод смордины. А Мишка съел на 22 ягод больше.	Сколько лет Петьке и Мишке в сумме?	-1
Петька съел 20 ягод смордины. А Мишка съел на 35 ягод больше.	Сколько лет Петьке и Мишке в сумме?	-1
Петька съел 3 ягод смордины. А Мишка съел на 9 ягод больше.	Сколько лет Петьке и Мишке в сумме?	-1
Петька съел 14 ягод смордины. А Мишка съел на 36 ягод больше.	Сколько лет Петьке и Мишке в сумме?	-1
Первый автобус проезжает маршрут за 4 часов. А второй автобус едет со скоростью 8 км/ч.	На сколько км/ч второй автобус быстрее?	-1
Первый автобус проезжает маршрут за 9 часов. А второй автобус едет со скоростью 10 км/ч.	На сколько км/ч второй автобус быстрее?	-1
Первый автобус проезжает маршрут за 3 часов. А второй автобус едет со скоростью 117 км/ч.	На сколько км/ч второй автобус быстрее?	-1
Первый автобус проезжает маршрут за 4 часов. А второй автобус едет со скоростью 63 км/ч.	На сколько км/ч второй автобус быстрее?	-1
Первый автобус проезжает маршрут за 5 часов. А второй автобус едет со скоростью 34 км/ч.	На сколько км/ч второй автобус быстрее?	-1
Первый автобус проезжает маршрут за 2 часов. А второй автобус едет со скоростью 67 км/ч.	На сколько км/ч второй автобус быстрее?	-1
Первый автобус проезжает маршрут за 9 часов. А второй автобус едет со скоростью 61 км/ч.	На сколько км/ч второй автобус быстрее?	-1
Первый автобус проезжает маршрут за 9 часов. А второй автобус едет со скоростью 65 км/ч.	На сколько км/ч второй автобус быстрее?	-1
Первый автобус проезжает маршрут за 2 часов. А второй автобус едет со скоростью 44 км/ч.	На сколько км/ч второй автобус быстрее?	-1
Первый автобус проезжает маршрут за 9 часов. А второй автобус едет со скоростью 92 км/ч.	На сколько км/ч второй автобус быстрее?	-1
Первый автобус проезжает маршрут за 2 часов. А второй автобус едет со скоростью 74 км/ч.	На сколько км/ч второй автобус быстрее?	-1
Первый автобус проезжает маршрут за 8 часов. А второй автобус едет со скоростью 97 км/ч.	На сколько км/ч второй автобус быстрее?	-1
Первый автобус проезжает маршрут за 4 часов. А второй автобус едет со скоростью 23 км/ч.	На сколько км/ч второй автобус быстрее?	-1
Первый автобус проезжает маршрут за 2 часов. А второй автобус едет со скоростью 41 км/ч.	На сколько км/ч второй автобус быстрее?	-1
Первый автобус проезжает маршрут за 9 часов. А второй автобус едет со скоростью 46 км/ч.	На сколько км/ч второй автобус быстрее?	-1
Первый автобус проезжает маршрут за 4 часов. А второй автобус едет со скоростью 49 км/ч.	На сколько км/ч второй автобус быстрее?	-1
Виктор взял 29 конфетки. Аня взяла только 12.	Сколько всего кофт у ребятишек??	-1
Виктор взял 27 конфетки. Аня взяла только 16.	Сколько всего кофт у ребятишек??	-1
Виктор взял 4 конфетки. Аня взяла только 1.	Сколько всего кофт у ребятишек??	-1
Виктор взял 20 конфетки. Аня взяла только 3.	Сколько всего кофт у ребятишек??	-1
Виктор взял 5 конфетки. Аня взяла только 4.	Сколько всего кофт у ребятишек??	-1
Виктор взял 23 конфетки. Аня взяла только 8.	Сколько всего кофт у ребятишек??	-1
Виктор взял 18 конфетки. Аня взяла только 14.	Сколько всего кофт у ребятишек??	-1
Виктор взял 22 конфетки. Аня взяла только 15.	Сколько всего кофт у ребятишек??	-1
Виктор взял 5 конфетки. Аня взяла только 4.	Сколько всего кофт у ребятишек??	-1
Виктор взял 8 конфетки. Аня взяла только 6.	Сколько всего кофт у ребятишек??	-1
Виктор взял 25 конфетки. Аня взяла только 16.	Сколько всего кофт у ребятишек??	-1
Виктор взял 28 конфетки. Аня взяла только 13.	Сколько всего кофт у ребятишек??	-1
Виктор взял 23 конфетки. Аня взяла только 6.	Сколько всего кофт у ребятишек??	-1
Виктор взял 29 конфетки. Аня взяла только 19.	Сколько всего кофт у ребятишек??	-1
Виктор взял 23 конфетки. Аня взяла только 11.	Сколько всего кофт у ребятишек??	-1
Виктор взял 15 конфетки. Аня взяла только 3.	Сколько всего кофт у ребятишек??	-1
Виктор взял 17 конфетки. Аня взяла только 16.	Сколько всего кофт у ребятишек??	-1
Семен скушал 22 вафли. А Аня съела 25 конфеты.	Сколько лет Ане и Семену вместе?	-1
Семен скушал 29 вафли. А Аня съела 14 конфеты.	Сколько лет Ане и Семену вместе?	-1
Семен скушал 8 вафли. А Аня съела 15 конфеты.	Сколько лет Ане и Семену вместе?	-1
Семен скушал 14 вафли. А Аня съела 9 конфеты.	Сколько лет Ане и Семену вместе?	-1
Семен скушал 8 вафли. А Аня съела 25 конфеты.	Сколько лет Ане и Семену вместе?	-1
Семен скушал 25 вафли. А Аня съела 1 конфеты.	Сколько лет Ане и Семену вместе?	-1
Семен скушал 29 вафли. А Аня съела 23 конфеты.	Сколько лет Ане и Семену вместе?	-1
Семен скушал 27 вафли. А Аня съела 8 конфеты.	Сколько лет Ане и Семену вместе?	-1
Семен скушал 12 вафли. А Аня съела 1 конфеты.	Сколько лет Ане и Семену вместе?	-1
Семен скушал 22 вафли. А Аня съела 8 конфеты.	Сколько лет Ане и Семену вместе?	-1
Семен скушал 27 вафли. А Аня съела 10 конфеты.	Сколько лет Ане и Семену вместе?	-1
Семен скушал 7 вафли. А Аня съела 20 конфеты.	Сколько лет Ане и Семену вместе?	-1
Семен скушал 18 вафли. А Аня съела 3 конфеты.	Сколько лет Ане и Семену вместе?	-1
Семен скушал 11 вафли. А Аня съела 8 конфеты.	Сколько лет Ане и Семену вместе?	-1
Семен скушал 11 вафли. А Аня съела 27 конфеты.	Сколько лет Ане и Семену вместе?	-1
Семен скушал 11 вафли. А Аня съела 13 конфеты.	Сколько лет Ане и Семену вместе?	-1
У Коли было на 80 наклеек больше, чем у Кати.	Сколько наклеек было у Кати?	-1
У Коли было на 112 наклеек больше, чем у Кати.	Сколько наклеек было у Кати?	-1
У Коли было на 137 наклеек больше, чем у Кати.	Сколько наклеек было у Кати?	-1
У Коли было на 34 наклеек больше, чем у Кати.	Сколько наклеек было у Кати?	-1
У Коли было на 20 наклеек больше, чем у Кати.	Сколько наклеек было у Кати?	-1
У Коли было на 200 наклеек больше, чем у Кати.	Сколько наклеек было у Кати?	-1
У Коли было на 96 наклеек больше, чем у Кати.	Сколько наклеек было у Кати?	-1
У Коли было на 237 наклеек больше, чем у Кати.	Сколько наклеек было у Кати?	-1
У Коли было на 175 наклеек больше, чем у Кати.	Сколько наклеек было у Кати?	-1
У Коли было на 32 наклеек больше, чем у Кати.	Сколько наклеек было у Кати?	-1
У Коли было на 188 наклеек больше, чем у Кати.	Сколько наклеек было у Кати?	-1
У Коли было на 39 наклеек больше, чем у Кати.	Сколько наклеек было у Кати?	-1
У Коли было на 247 наклеек больше, чем у Кати.	Сколько наклеек было у Кати?	-1
У Коли было на 286 наклеек больше, чем у Кати.	Сколько наклеек было у Кати?	-1
У Коли было на 15 наклеек больше, чем у Кати.	Сколько наклеек было у Кати?	-1
У Коли было на 257 наклеек больше, чем у Кати.	Сколько наклеек было у Кати?	-1
Ширина первой комнаты - 34 метра. Вторая комната шире её ровно в 5 раз.	Сколько в ширину кухня?	-1
Ширина первой комнаты - 9 метра. Вторая комната шире её ровно в 3 раз.	Сколько в ширину кухня?	-1
Ширина первой комнаты - 9 метра. Вторая комната шире её ровно в 8 раз.	Сколько в ширину кухня?	-1
Ширина первой комнаты - 26 метра. Вторая комната шире её ровно в 7 раз.	Сколько в ширину кухня?	-1
Ширина первой комнаты - 28 метра. Вторая комната шире её ровно в 3 раз.	Сколько в ширину кухня?	-1
Ширина первой комнаты - 3 метра. Вторая комната шире её ровно в 6 раз.	Сколько в ширину кухня?	-1
Ширина первой комнаты - 49 метра. Вторая комната шире её ровно в 5 раз.	Сколько в ширину кухня?	-1
Ширина первой комнаты - 19 метра. Вторая комната шире её ровно в 7 раз.	Сколько в ширину кухня?	-1
Ширина первой комнаты - 42 метра. Вторая комната шире её ровно в 4 раз.	Сколько в ширину кухня?	-1
Ширина первой комнаты - 19 метра. Вторая комната шире её ровно в 2 раз.	Сколько в ширину кухня?	-1
Ширина первой комнаты - 28 метра. Вторая комната шире её ровно в 4 раз.	Сколько в ширину кухня?	-1
Ширина первой комнаты - 11 метра. Вторая комната шире её ровно в 4 раз.	Сколько в ширину кухня?	-1
Ширина первой комнаты - 20 метра. Вторая комната шире её ровно в 4 раз.	Сколько в ширину кухня?	-1
Ширина первой комнаты - 16 метра. Вторая комната шире её ровно в 8 раз.	Сколько в ширину кухня?	-1
Ширина первой комнаты - 19 метра. Вторая комната шире её ровно в 6 раз.	Сколько в ширину кухня?	-1
Ширина первой комнаты - 40 метра. Вторая комната шире её ровно в 9 раз.	Сколько в ширину кухня?	-1
Высота первой комнаты - 24 метра. Вторая комната шире её ровно в 2 раз.	Чему равна высота второй комнаты?	-1
Высота первой комнаты - 9 метра. Вторая комната шире её ровно в 8 раз.	Чему равна высота второй комнаты?	-1
Высота первой комнаты - 5 метра. Вторая комната шире её ровно в 3 раз.	Чему равна высота второй комнаты?	-1
Высота первой комнаты - 19 метра. Вторая комната шире её ровно в 6 раз.	Чему равна высота второй комнаты?	-1
Высота первой комнаты - 26 метра. Вторая комната шире её ровно в 3 раз.	Чему равна высота второй комнаты?	-1
Высота первой комнаты - 12 метра. Вторая комната шире её ровно в 7 раз.	Чему равна высота второй комнаты?	-1
Высота первой комнаты - 4 метра. Вторая комната шире её ровно в 8 раз.	Чему равна высота второй комнаты?	-1
Высота первой комнаты - 25 метра. Вторая комната шире её ровно в 3 раз.	Чему равна высота второй комнаты?	-1
Высота первой комнаты - 29 метра. Вторая комната шире её ровно в 7 раз.	Чему равна высота второй комнаты?	-1
Высота первой комнаты - 20 метра. Вторая комната шире её ровно в 6 раз.	Чему равна высота второй комнаты?	-1
Высота первой комнаты - 49 метра. Вторая комната шире её ровно в 2 раз.	Чему равна высота второй комнаты?	-1
Высота первой комнаты - 29 метра. Вторая комната шире её ровно в 2 раз.	Чему равна высота второй комнаты?	-1
Высота первой комнаты - 3 метра. Вторая комната шире её ровно в 2 раз.	Чему равна высота второй комнаты?	-1
Высота первой комнаты - 4 метра. Вторая комната шире её ровно в 9 раз.	Чему равна высота второй комнаты?	-1
Высота первой комнаты - 30 метра. Вторая комната шире её ровно в 6 раз.	Чему равна высота второй комнаты?	-1
Высота первой комнаты - 14 метра. Вторая комната шире её ровно в 4 раз.	Чему равна высота второй комнаты?	-1
15 декабря в 7 часов вечера на катке каталось 17 ребят. Через один час какое-то количество ребят ушли домой. На катке осталось 9 ребят.	Сколько девочек было среди них?	-1
15 декабря в 8 часов вечера на катке каталось 19 ребят. Через один час какое-то количество ребят ушли домой. На катке осталось 4 ребят.	Сколько девочек было среди них?	-1
22 декабря в 7 часов вечера на катке каталось 44 ребят. Через один час какое-то количество ребят ушли домой. На катке осталось 27 ребят.	Сколько девочек было среди них?	-1
9 декабря в 8 часов вечера на катке каталось 22 ребят. Через один час какое-то количество ребят ушли домой. На катке осталось 6 ребят.	Сколько девочек было среди них?	-1
4 декабря в 6 часов вечера на катке каталось 37 ребят. Через один час какое-то количество ребят ушли домой. На катке осталось 15 ребят.	Сколько девочек было среди них?	-1
11 декабря в 8 часов вечера на катке каталось 37 ребят. Через один час какое-то количество ребят ушли домой. На катке осталось 12 ребят.	Сколько девочек было среди них?	-1
8 декабря в 6 часов вечера на катке каталось 41 ребят. Через один час какое-то количество ребят ушли домой. На катке осталось 9 ребят.	Сколько девочек было среди них?	-1
5 декабря в 6 часов вечера на катке каталось 16 ребят. Через один час какое-то количество ребят ушли домой. На катке осталось 5 ребят.	Сколько девочек было среди них?	-1
24 декабря в 7 часов вечера на катке каталось 24 ребят. Через один час какое-то количество ребят ушли домой. На катке осталось 15 ребят.	Сколько девочек было среди них?	-1
9 декабря в 6 часов вечера на катке каталось 23 ребят. Через один час какое-то количество ребят ушли домой. На катке осталось 8 ребят.	Сколько девочек было среди них?	-1
19 декабря в 6 часов вечера на катке каталось 37 ребят. Через один час какое-то количество ребят ушли домой. На катке осталось 11 ребят.	Сколько девочек было среди них?	-1
6 декабря в 6 часов вечера на катке каталось 26 ребят. Через один час какое-то количество ребят ушли домой. На катке осталось 9 ребят.	Сколько девочек было среди них?	-1
22 декабря в 6 часов вечера на катке каталось 16 ребят. Через один час какое-то количество ребят ушли домой. На катке осталось 7 ребят.	Сколько девочек было среди них?	-1
19 декабря в 7 часов вечера на катке каталось 40 ребят. Через один час какое-то количество ребят ушли домой. На катке осталось 16 ребят.	Сколько девочек было среди них?	-1
7 декабря в 6 часов вечера на катке каталось 48 ребят. Через один час какое-то количество ребят ушли домой. На катке осталось 9 ребят.	Сколько девочек было среди них?	-1
11 декабря в 7 часов вечера на катке каталось 17 ребят. Через один час какое-то количество ребят ушли домой. На катке осталось 6 ребят.	Сколько девочек было среди них?	-1
В супермаркете Коля купил 3 стаканчика мороженого за 45, 38 и 43 руб.	Сколько сдачи дали Коле?	-1
В супермаркете Коля купил 3 стаканчика мороженого за 41, 38 и 79 руб.	Сколько сдачи дали Коле?	-1
В супермаркете Коля купил 3 стаканчика мороженого за 35, 25 и 64 руб.	Сколько сдачи дали Коле?	-1
В супермаркете Коля купил 3 стаканчика мороженого за 15, 63 и 73 руб.	Сколько сдачи дали Коле?	-1
В супермаркете Коля купил 3 стаканчика мороженого за 26, 87 и 23 руб.	Сколько сдачи дали Коле?	-1
В супермаркете Коля купил 3 стаканчика мороженого за 34, 82 и 85 руб.	Сколько сдачи дали Коле?	-1
В супермаркете Коля купил 3 стаканчика мороженого за 34, 75 и 87 руб.	Сколько сдачи дали Коле?	-1
В супермаркете Коля купил 3 стаканчика мороженого за 16, 87 и 69 руб.	Сколько сдачи дали Коле?	-1
В супермаркете Коля купил 3 стаканчика мороженого за 46, 54 и 57 руб.	Сколько сдачи дали Коле?	-1
В супермаркете Коля купил 3 стаканчика мороженого за 24, 32 и 44 руб.	Сколько сдачи дали Коле?	-1
В супермаркете Коля купил 3 стаканчика мороженого за 31, 77 и 76 руб.	Сколько сдачи дали Коле?	-1
В супермаркете Коля купил 3 стаканчика мороженого за 23, 26 и 40 руб.	Сколько сдачи дали Коле?	-1
В супермаркете Коля купил 3 стаканчика мороженого за 27, 27 и 51 руб.	Сколько сдачи дали Коле?	-1
В супермаркете Коля купил 3 стаканчика мороженого за 25, 18 и 39 руб.	Сколько сдачи дали Коле?	-1
В супермаркете Коля купил 3 стаканчика мороженого за 45, 61 и 73 руб.	Сколько сдачи дали Коле?	-1
В супермаркете Коля купил 3 стаканчика мороженого за 14, 41 и 27 руб.	Сколько сдачи дали Коле?	-1
	Какое число получится, если вычесть 4334 и прибавить 73224?	-1
	Какое число получится, если вычесть 3950 и прибавить 68282?	-1
	Какое число получится, если вычесть 3172 и прибавить 39750?	-1
	Какое число получится, если вычесть 728 и прибавить 36119?	-1
	Какое число получится, если вычесть 1770 и прибавить 67114?	-1
	Какое число получится, если вычесть 781 и прибавить 7962?	-1
	Какое число получится, если вычесть 810 и прибавить 33508?	-1
	Какое число получится, если вычесть 991 и прибавить 35880?	-1
	Какое число получится, если вычесть 545 и прибавить 54013?	-1
	Какое число получится, если вычесть 1753 и прибавить 29009?	-1
	Какое число получится, если вычесть 2431 и прибавить 70169?	-1
	Какое число получится, если вычесть 3361 и прибавить 37906?	-1
	Какое число получится, если вычесть 196 и прибавить 10224?	-1
	Какое число получится, если вычесть 526 и прибавить 28652?	-1
	Какое число получится, если вычесть 312 и прибавить 50580?	-1
	Какое число получится, если вычесть 2528 и прибавить 78652?	-1
	В какое число раз 284 больше 361?	-1
	В какое число раз 3416 больше 4899?	-1
	В какое число раз 4079 больше 4756?	-1
	В какое число раз 1683 больше 2628?	-1
	В какое число раз 673 больше 1237?	-1
	В какое число раз 1083 больше 3130?	-1
	В какое число раз 2877 больше 4739?	-1
	В какое число раз 116 больше 229?	-1
	В какое число раз 422 больше 779?	-1
	В какое число раз 1031 больше 2236?	-1
	В какое число раз 92 больше 356?	-1
	В какое число раз 790 больше 1058?	-1
	В какое число раз 2510 больше 4579?	-1
	В какое число раз 378 больше 1707?	-1
	В какое число раз 2469 больше 2802?	-1
	В какое число раз 797 больше 1668?	-1
Сегодня Лара купила в магазине 28 конфет. 4 она съела.	Сколько конфет она купила вчера?	-1
Сегодня Лара купила в магазине 48 конфет. 2 она съела.	Сколько конфет она купила вчера?	-1
Сегодня Лара купила в магазине 56 конфет. 10 она съела.	Сколько конфет она купила вчера?	-1
Сегодня Лара купила в магазине 87 конфет. 69 она съела.	Сколько конфет она купила вчера?	-1
Сегодня Лара купила в магазине 73 конфет. 17 она съела.	Сколько конфет она купила вчера?	-1
Сегодня Лара купила в магазине 31 конфет. 11 она съела.	Сколько конфет она купила вчера?	-1
Сегодня Лара купила в магазине 46 конфет. 24 она съела.	Сколько конфет она купила вчера?	-1
Сегодня Лара купила в магазине 70 конфет. 15 она съела.	Сколько конфет она купила вчера?	-1
Сегодня Лара купила в магазине 36 конфет. 11 она съела.	Сколько конфет она купила вчера?	-1
Сегодня Лара купила в магазине 66 конфет. 16 она съела.	Сколько конфет она купила вчера?	-1
Сегодня Лара купила в магазине 37 конфет. 22 она съела.	Сколько конфет она купила вчера?	-1
Сегодня Лара купила в магазине 90 конфет. 61 она съела.	Сколько конфет она купила вчера?	-1
Сегодня Лара купила в магазине 83 конфет. 68 она съела.	Сколько конфет она купила вчера?	-1
Сегодня Лара купила в магазине 93 конфет. 65 она съела.	Сколько конфет она купила вчера?	-1
Сегодня Лара купила в магазине 23 конфет. 11 она съела.	Сколько конфет она купила вчера?	-1
Сегодня Лара купила в магазине 2 конфет. 1 она съела.	Сколько конфет она купила вчера?	-1
У Ани 79 яиц. Под них у неё есть 7 пустые коробки. В каждую коробку входит по 16 яиц.	Сколько яиц разбилось, когда она укладывала их в коробки?	-1
У Ани 95 яиц. Под них у неё есть 9 пустые коробки. В каждую коробку входит по 19 яиц.	Сколько яиц разбилось, когда она укладывала их в коробки?	-1
У Ани 24 яиц. Под них у неё есть 5 пустые коробки. В каждую коробку входит по 3 яиц.	Сколько яиц разбилось, когда она укладывала их в коробки?	-1
У Ани 96 яиц. Под них у неё есть 7 пустые коробки. В каждую коробку входит по 14 яиц.	Сколько яиц разбилось, когда она укладывала их в коробки?	-1
У Ани 17 яиц. Под них у неё есть 5 пустые коробки. В каждую коробку входит по 12 яиц.	Сколько яиц разбилось, когда она укладывала их в коробки?	-1
У Ани 42 яиц. Под них у неё есть 8 пустые коробки. В каждую коробку входит по 14 яиц.	Сколько яиц разбилось, когда она укладывала их в коробки?	-1
У Ани 77 яиц. Под них у неё есть 5 пустые коробки. В каждую коробку входит по 4 яиц.	Сколько яиц разбилось, когда она укладывала их в коробки?	-1
У Ани 99 яиц. Под них у неё есть 5 пустые коробки. В каждую коробку входит по 15 яиц.	Сколько яиц разбилось, когда она укладывала их в коробки?	-1
У Ани 80 яиц. Под них у неё есть 9 пустые коробки. В каждую коробку входит по 12 яиц.	Сколько яиц разбилось, когда она укладывала их в коробки?	-1
У Ани 83 яиц. Под них у неё есть 6 пустые коробки. В каждую коробку входит по 9 яиц.	Сколько яиц разбилось, когда она укладывала их в коробки?	-1
У Ани 53 яиц. Под них у неё есть 5 пустые коробки. В каждую коробку входит по 4 яиц.	Сколько яиц разбилось, когда она укладывала их в коробки?	-1
У Ани 81 яиц. Под них у неё есть 9 пустые коробки. В каждую коробку входит по 16 яиц.	Сколько яиц разбилось, когда она укладывала их в коробки?	-1
У Ани 30 яиц. Под них у неё есть 5 пустые коробки. В каждую коробку входит по 15 яиц.	Сколько яиц разбилось, когда она укладывала их в коробки?	-1
У Ани 69 яиц. Под них у неё есть 7 пустые коробки. В каждую коробку входит по 18 яиц.	Сколько яиц разбилось, когда она укладывала их в коробки?	-1
У Ани 16 яиц. Под них у неё есть 7 пустые коробки. В каждую коробку входит по 3 яиц.	Сколько яиц разбилось, когда она укладывала их в коробки?	-1
У Ани 80 яиц. Под них у неё есть 8 пустые коробки. В каждую коробку входит по 16 яиц.	Сколько яиц разбилось, когда она укладывала их в коробки?	-1
В коллекции Коли есть марки 20 и 21 веков. Марок 20 века у него 672.	Сколько у него марок 21 века?	-1
В коллекции Коли есть марки 20 и 21 веков. Марок 20 века у него 178.	Сколько у него марок 21 века?	-1
В коллекции Коли есть марки 20 и 21 веков. Марок 20 века у него 780.	Сколько у него марок 21 века?	-1
В коллекции Коли есть марки 20 и 21 веков. Марок 20 века у него 105.	Сколько у него марок 21 века?	-1
В коллекции Коли есть марки 20 и 21 веков. Марок 20 века у него 987.	Сколько у него марок 21 века?	-1
В коллекции Коли есть марки 20 и 21 веков. Марок 20 века у него 218.	Сколько у него марок 21 века?	-1
В коллекции Коли есть марки 20 и 21 веков. Марок 20 века у него 849.	Сколько у него марок 21 века?	-1
В коллекции Коли есть марки 20 и 21 веков. Марок 20 века у него 677.	Сколько у него марок 21 века?	-1
В коллекции Коли есть марки 20 и 21 веков. Марок 20 века у него 954.	Сколько у него марок 21 века?	-1
В коллекции Коли есть марки 20 и 21 веков. Марок 20 века у него 630.	Сколько у него марок 21 века?	-1
В коллекции Коли есть марки 20 и 21 веков. Марок 20 века у него 457.	Сколько у него марок 21 века?	-1
В коллекции Коли есть марки 20 и 21 веков. Марок 20 века у него 232.	Сколько у него марок 21 века?	-1
В коллекции Коли есть марки 20 и 21 веков. Марок 20 века у него 745.	Сколько у него марок 21 века?	-1
В коллекции Коли есть марки 20 и 21 веков. Марок 20 века у него 736.	Сколько у него марок 21 века?	-1
В коллекции Коли есть марки 20 и 21 веков. Марок 20 века у него 686.	Сколько у него марок 21 века?	-1
В коллекции Коли есть марки 20 и 21 веков. Марок 20 века у него 638.	Сколько у него марок 21 века?	-1
Коля купил 32 тетрадей и 25 ручек. 	Сколько он заплатил за покупку, если одна тетрадь стоит 7 рублей?	-1
Коля купил 76 тетрадей и 61 ручек. 	Сколько он заплатил за покупку, если одна тетрадь стоит 13 рублей?	-1
Коля купил 90 тетрадей и 48 ручек. 	Сколько он заплатил за покупку, если одна тетрадь стоит 8 рублей?	-1
Коля купил 15 тетрадей и 99 ручек. 	Сколько он заплатил за покупку, если одна тетрадь стоит 18 рублей?	-1
Коля купил 9 тетрадей и 57 ручек. 	Сколько он заплатил за покупку, если одна тетрадь стоит 19 рублей?	-1
Коля купил 78 тетрадей и 66 ручек. 	Сколько он заплатил за покупку, если одна тетрадь стоит 3 рублей?	-1
Коля купил 55 тетрадей и 97 ручек. 	Сколько он заплатил за покупку, если одна тетрадь стоит 4 рублей?	-1
Коля купил 18 тетрадей и 17 ручек. 	Сколько он заплатил за покупку, если одна тетрадь стоит 8 рублей?	-1
Коля купил 87 тетрадей и 35 ручек. 	Сколько он заплатил за покупку, если одна тетрадь стоит 4 рублей?	-1
Коля купил 59 тетрадей и 9 ручек. 	Сколько он заплатил за покупку, если одна тетрадь стоит 19 рублей?	-1
Коля купил 65 тетрадей и 86 ручек. 	Сколько он заплатил за покупку, если одна тетрадь стоит 19 рублей?	-1
Коля купил 55 тетрадей и 99 ручек. 	Сколько он заплатил за покупку, если одна тетрадь стоит 4 рублей?	-1
Коля купил 56 тетрадей и 37 ручек. 	Сколько он заплатил за покупку, если одна тетрадь стоит 5 рублей?	-1
Коля купил 45 тетрадей и 10 ручек. 	Сколько он заплатил за покупку, если одна тетрадь стоит 9 рублей?	-1
Коля купил 86 тетрадей и 6 ручек. 	Сколько он заплатил за покупку, если одна тетрадь стоит 16 рублей?	-1
Коля купил 27 тетрадей и 20 ручек. 	Сколько он заплатил за покупку, если одна тетрадь стоит 10 рублей?	-1
Алексею 40 лет. Сергей моложе его на 10 лет.	Сколько было лет Сергею, когда Алексей родился?	-1
Алексею 59 лет. Сергей моложе его на 8 лет.	Сколько было лет Сергею, когда Алексей родился?	-1
Алексею 54 лет. Сергей моложе его на 13 лет.	Сколько было лет Сергею, когда Алексей родился?	-1
Алексею 50 лет. Сергей моложе его на 12 лет.	Сколько было лет Сергею, когда Алексей родился?	-1
Алексею 16 лет. Сергей моложе его на 6 лет.	Сколько было лет Сергею, когда Алексей родился?	-1
Алексею 48 лет. Сергей моложе его на 6 лет.	Сколько было лет Сергею, когда Алексей родился?	-1
Алексею 21 лет. Сергей моложе его на 13 лет.	Сколько было лет Сергею, когда Алексей родился?	-1
Алексею 41 лет. Сергей моложе его на 8 лет.	Сколько было лет Сергею, когда Алексей родился?	-1
Алексею 20 лет. Сергей моложе его на 5 лет.	Сколько было лет Сергею, когда Алексей родился?	-1
Алексею 55 лет. Сергей моложе его на 13 лет.	Сколько было лет Сергею, когда Алексей родился?	-1
Алексею 58 лет. Сергей моложе его на 9 лет.	Сколько было лет Сергею, когда Алексей родился?	-1
Алексею 58 лет. Сергей моложе его на 7 лет.	Сколько было лет Сергею, когда Алексей родился?	-1
Алексею 20 лет. Сергей моложе его на 9 лет.	Сколько было лет Сергею, когда Алексей родился?	-1
Алексею 58 лет. Сергей моложе его на 7 лет.	Сколько было лет Сергею, когда Алексей родился?	-1
Алексею 19 лет. Сергей моложе его на 6 лет.	Сколько было лет Сергею, когда Алексей родился?	-1
Алексею 30 лет. Сергей моложе его на 12 лет.	Сколько было лет Сергею, когда Алексей родился?	-1
Алексею 48 лет. Сергей моложе его на 13 лет.	Сколько было лет Сергею, когда Алексей родился?	-1
На мультфильме в кинотеатре во втором ряду сидело на 27 мальчиков больше, чем девочек. 	Сколько мальчиков и девочек вместе сидело на втором ряду?	-1
На мультфильме в кинотеатре во втором ряду сидело на 41 мальчиков больше, чем девочек. 	Сколько мальчиков и девочек вместе сидело на втором ряду?	-1
На мультфильме в кинотеатре во втором ряду сидело на 22 мальчиков больше, чем девочек. 	Сколько мальчиков и девочек вместе сидело на втором ряду?	-1
На мультфильме в кинотеатре во втором ряду сидело на 48 мальчиков больше, чем девочек. 	Сколько мальчиков и девочек вместе сидело на втором ряду?	-1
На мультфильме в кинотеатре во втором ряду сидело на 34 мальчиков больше, чем девочек. 	Сколько мальчиков и девочек вместе сидело на втором ряду?	-1
На мультфильме в кинотеатре во втором ряду сидело на 17 мальчиков больше, чем девочек. 	Сколько мальчиков и девочек вместе сидело на втором ряду?	-1
На мультфильме в кинотеатре во втором ряду сидело на 26 мальчиков больше, чем девочек. 	Сколько мальчиков и девочек вместе сидело на втором ряду?	-1
На мультфильме в кинотеатре во втором ряду сидело на 48 мальчиков больше, чем девочек. 	Сколько мальчиков и девочек вместе сидело на втором ряду?	-1
На мультфильме в кинотеатре во втором ряду сидело на 11 мальчиков больше, чем девочек. 	Сколько мальчиков и девочек вместе сидело на втором ряду?	-1
На мультфильме в кинотеатре во втором ряду сидело на 36 мальчиков больше, чем девочек. 	Сколько мальчиков и девочек вместе сидело на втором ряду?	-1
На мультфильме в кинотеатре во втором ряду сидело на 31 мальчиков больше, чем девочек. 	Сколько мальчиков и девочек вместе сидело на втором ряду?	-1
На мультфильме в кинотеатре во втором ряду сидело на 11 мальчиков больше, чем девочек. 	Сколько мальчиков и девочек вместе сидело на втором ряду?	-1
На мультфильме в кинотеатре во втором ряду сидело на 49 мальчиков больше, чем девочек. 	Сколько мальчиков и девочек вместе сидело на втором ряду?	-1
На мультфильме в кинотеатре во втором ряду сидело на 22 мальчиков больше, чем девочек. 	Сколько мальчиков и девочек вместе сидело на втором ряду?	-1
На мультфильме в кинотеатре во втором ряду сидело на 38 мальчиков больше, чем девочек. 	Сколько мальчиков и девочек вместе сидело на втором ряду?	-1
На мультфильме в кинотеатре во втором ряду сидело на 13 мальчиков больше, чем девочек. 	Сколько мальчиков и девочек вместе сидело на втором ряду?	-1
На мультфильме в кинотеатре во втором ряду сидело на 36 мальчиков больше, чем девочек. 	Сколько мальчиков и девочек вместе сидело на втором ряду?	-1
На мультфильме в кинотеатре во втором ряду сидело на 29 мальчиков больше, чем девочек. 	Сколько мальчиков и девочек вместе сидело на втором ряду?	-1
На мультфильме в кинотеатре во втором ряду сидело на 29 мальчиков больше, чем девочек. 	Сколько мальчиков и девочек вместе сидело на втором ряду?	-1
На мультфильме в кинотеатре во втором ряду сидело на 15 мальчиков больше, чем девочек. 	Сколько мальчиков и девочек вместе сидело на втором ряду?	-1
На мультфильме в кинотеатре во втором ряду сидело на 31 мальчиков больше, чем девочек. 	Сколько мальчиков и девочек вместе сидело на втором ряду?	-1
На мультфильме в кинотеатре во втором ряду сидело на 40 мальчиков больше, чем девочек. 	Сколько мальчиков и девочек вместе сидело на втором ряду?	-1
